######/////
#....######
#.@..##...#
#....##...#
###.#####.#
//#.......#
//#########