/#####/////////####/
#....######///##..##
#.@..##...#///#....#
#....##...#//##..$.#
###.#####.#//#.....#
//#..s....#//#.#####
//####.####//#.#////
////#..#/////#.###//
////#.########...#//
//###.##......s..#//
//#....../////.###//
//#......////...#///
//#.s...........#///
//###############///
////////////////////