/#####/////////####/
#....######///##..##
#.@..##...#///#....#
#....##...#//##....#
###.#####.#//#.....#
//#.......#//#.#####
//####.####//#.#////
////#..#/////#.###//
////#.########...#//
//###.##.........#//
//#....../////.###//
//#......////...#///
//#.............#///
//###############///
////////////////////