#/####/////////####/
#....######///##..##
#.@..##...#///#..$.#
#....##...#//##....#
###s#####.#//#.....#
//#.......#//#.#####
//####.####//#.#////
////#..#/////#.###//
////#.########...#//
//###.##..s......#//
//#.s..../////.###//
//#......////...#///
//#.............#///
//###############///
////////////////////