##/###/////////####/
#....######///##..##
#.@..##...#///#....#
#....##...#//##.$..#
###.#####.#//#s....#
//#.......#//#.#####
//####.####//#.#////
////#..#/////#.###//
////#.########...#//
//###.##.........#//
//#....../////.###//
//#..s...////...#///
//#..........s..#///
//###############///
////////////////////