####/#/////////####/
#....######///##..##
#.@..##...#///#....#
#....##...#//##..$.#
###.#####.#//#.....#
//#.......#//#.#####
//####.####//#.#////
////#s.#/////#.###//
////#.########...#//
//###.##.........#//
//#.s..../////.###//
//#......////s..#///
//#.............#///
//###############///
////////////////////