////////////////////
/////////$//////////
////////////////////
////////###/////////
////////#$#/////////
////////#.#/////////
///////##s##////////
//$////#...#////$///
///////##@##////////
////////###/////////
////////////////////
////////////////////
////////////////////
/////////$//////////
////////////////////