////////////////////
/////////$//////////
////////////////////
////////###/////////
////////#$#/////////
////////#.#/////////
///////##b##////////
//$////#...#////$///
///////##@##////////
////////###/////////
////////////////////
////////////////////
////////////////////
/////////$//////////
////////////////////