######/////////####/
#....######///##$.##
#.@..##...#///#....#
#....##...#//##....#
###.#####.#//#.....#
//#..s....#//#.#####
//####.####//#s#////
////#..#/////#.###//
////#.########...#//
//###.##.........#//
//#....../////.###//
//#..s...////...#///
//#........s....#///
//###############///
////////////////////